####################
E..........#####..##
######.###....######
#...##.######.######
#...##....K##T######
#...######....######
####################
