########
#...X..#
#....#K#
#...X#.#
E.!..#.#
#.####!#
#..T...#
########
