########
#!#...T#
#.#....#
#.#....#
E.#..!.#
###..K.#
#......#
########
