#K####
#....#
#..#.#
#...T#
###E##
