


###E#####
###.#####
##....###
##.#.####
#K....###
###..T.##
#########


