##E###
#.K..#
#.##.#
#.T..#
######